o---------
o---------
o----o----
o----o----
o----o----
----------
-oooo-----
-------o--
---oo--o--
-------o--